NO ./test_textures/brick.xpm
SO ./test_textures/dirt.xpm
WE ./test_textures/metal.xpm
EA ./test_textures/wood.xpm

F 120,120,0
C 0,0,255


111111111111111111111
100000000000000000000111111111111
100000000000000000000000000000001
100010000001111111111111000000001
100000000001100000000000000000001
100000000001111111000000000000001
100000000000000001000000000000001
100000000100111101111010100011101
100000000001111101000000000010001
1000000000011001000000000000100011
100000010001100000000000000010001
100000000001100000000000000010001
100001000001111110000111111110001
111111000001100000000000000000001
10E00000000000000000011000001111
111111000000000000000000000000001
100000000000000001111111000000001
100000000001100000000000000000001
100000000001111111000000000000001
10000000000000001000000000000001
100000000100111101111010100011101
100000000001111101000000000010001
100000000001100100000000000010001
100000010000000000000000000010001
100000000001100000000000000010001
100001000000000000000000011110001
100000000001100000000000000000001
111111111111111111111111111111111