NO ./test_textures/metal_3.xpm
SO ./test_textures/metal_2.xpm
WE ./test_textures/metal.xpm
EA ./invalid/path/to/text

F 120,120,0
C 0,0,255


1111111111111
1000000000011
1000000000011
1000100000011
1000000000011
1000000000011
1000000000101
1000000001001
1000000000011
1000000000011
1000000100011
1000000000011
1000010000011
1000000000011
1111111111111