NO ./test_textures/brick.xpm
SO ./test_textures/dirt.xpm
WE ./test_textures/metal.xpm
EA ./test_textures/wood.xpm

F 120,120,0
C 0,0,255


111111111111111111111111111111111
100000000100000000000100000000001
100010000101111111110111000000001
100000000101000000010100000101001
101111100101011111010100000010001
101000100101010001010100000000001
1010001001010101N101010100011101
10110110010101011101010000010001
10000000010101000001010000001001
10000001010101111111010000000001
10000000010100000000010000001001
10000100010111111111111111110001
10000000000000000000000000000001
11111111111111111111111111111111