NO ./test_textures/brick.xpm
SO ./test_textures/dirt.xpm
WE ./test_textures/metal.xpm
EA ./test_textures/wood.xpm

F 120,120,0
C 0,0,255


1111111111111
1000000000001
100000E000011
1100000000101
1110000001001
1111111111111