NO ./ruta_a_la_textura_norte
SO ./ruta_a_la_textura_sur
WE ./ruta_a_la_textura_oeste
EA ./ruta_a_la_textura_este

F 255,0,0
C 255,0,0


1111111111111
1000000000001
100000E000011
1000000000101
1000000001001
1111111111111